15
44
w    w                                     w
w    w      wwwwwwwwwwwwwwwwwwwwww         w
w    w            w                        w
w    w   s         w                       w
w    w            w               wwwww    w
w                 w               w f w    w
w    w                            w   w    w
w    w                            w        w
www  w                            w   w    w
w                                 w   w    w
wwwwwwwwww  wwwww wwwwww   wwwwwwww   w    w
w                                          w
wwwwwwwwwwwwwwwwwwwwwwwwwwwwwwwwwwwwwwwwwwww